#########
#.....###
#.###.#.#
#.....#.#
#.###.#.#
#.......#
#########